########
##   ###
## #   #
#PCI I #
# C.# ##
##    ##
########