#######
#    ##
# #I ##
#  CC #
###.@ #
###   #
#######