#######
#   ###
# CP  #
##. I #
# . # #
#     #
#######