#######
## P###
##C.###
#  I  #
# #I  #
# C  ##
###  ##
#######