#######
##  ###
#  C  #
# @C  #
## C###
##I I #
##    #
#######