########
##   ###
## # I##
##C I  #
#PCIC  #
#   ####
########