######
###  #
### I#
#  . #
# #P #
# C. #
##   #
######