#######
###  ##
## I ##
# C.C #
# #I  #
#  P  #
#######