#######
# I   #
# #C  #
# CI# #
##ICP #
##  ###
##  ###
#######