#######
##   ##
##IIC##
#  I  #
#  CC #
####P #
#######